
(#)(#)(#)(#)(#)
(#)(.)(.)(.)(#)
(#)(.)(P)(.)(#)
(#)(.)(.)(.)(#)
(#)(.)(MA)(.)(#)
(#)(.)(.)(.)(#)
(#)(.)(.)(.)(#)
(#)(.)(.)(.)(#)
(#)(.)(6)(.)(#)
(#)(.)(.)(.)(#)
(#)(.)(.)(.)(#)
(#)(MP)(.)(.)(#)
(#)(.)(.)(.)(#)
(#)(#)(#)(#)(#)
