####################
#.E..............E.#
#..................#
#..........##......#
#......D...........#
#......####........#
#..................#
#.E..............E.#
#................P.#
####################